1. XboxNetApiSvc - Proporciona servicios de red para Xbox.
2. XblGameSave - Gestiona el almacenamiento en la nube de los juegos de Xbox.
3. XblAuthManager - Gestiona la autenticación para Xbox Live.
4. WManSvc - Windows Manager Service, relacionado con la administración de ventanas.
5. WinRM - Windows Remote Management, permite la administración remota de sistemas Windows.
6. WFDSConMgrSvc - Windows Feedback Data Collection and Upload Manager.
7. WdiSystemHost - Proveedor de servicios para la infraestructura de diagnóstico de Windows.
8. WdiServiceHost - Anfitrión de servicios de diagnóstico de Windows.
9. WbioSrvc - Windows Biometric Service, para dispositivos biométricos.
10.WalletService - Gestiona la funcionalidad de billetera digital.
11. vmicvss - VSS Provider for Hyper-V.
12. vmicvmsession - Sesión de máquina virtual para Hyper-V.
13. vmictimesync - Sincronización de tiempo para Hyper-V.
14. vmicshutdown - Apagado de máquina virtual para Hyper-V.
15. vmicrdv - Redireccionamiento de dispositivos virtuales para Hyper-V.
16. vmickvpexchange - Intercambio de claves para Hyper-V.
17. vmicheartbeat - Controla el estado de las máquinas virtuales en Hyper-V.
18. vmicguestinterface - Interfaz de invitado para Hyper-V.
19. UmRdpService - Remote Desktop Protocol (RDP) para Universal Windows Platform (UWP).
20. uhssvc - User Experience Virtualization (UE-V) Host Service.
21. UevAgentService - User Experience Virtualization (UE-V) Agent Service.
22. tzautoupdate - Actualización automática de zona horaria de Windows.
23. TermService - Servicio de Terminal Server para conexiones de Escritorio Remoto.
24. TapiSrv - Telephony API (TAPI) para servicios de telefonía.
25. SysMain - Superfetch, mantiene y mejora el rendimiento del sistema.
26. ssh-agent - Agente SSH para la autenticación de claves.
27. Spooler - Spooler de impresión para la gestión de trabajos de impresión.
28. shpamsvc - Protección de acceso a almacenamiento compartido.
29. SessionEnv - Servicio de entorno de sesión para servicios de sesión remota.
30. SEMgrSvc - Service Experience Manager para recopilación de datos de experiencia del usuario.
31. SCPolicySvc - Servicio de directivas de conexión segura.
32. SCardSvr - Smart Card Resource Manager para tarjetas inteligentes.
33. RpcLocator - Localizador de procedimientos remotos para la comunicación entre procesos.
34. RmSvc - Gestión de recursos para aplicaciones de Windows.
35. RetailDemo - Demostración minorista de Windows.
36. RemoteRegistry - Acceso remoto al registro de Windows.
37. RemoteAccess - Acceso remoto a recursos de red.
38. PrintNotify - Notificación de impresión para la administración de trabajos de impresión.
39. PhoneSvc - Servicio de teléfono para funciones de telefonía en Windows.
40. NetTcpPortSharing - Compartición de puertos TCP para servicios.
41. MsKeyboardFilter - Filtro de teclado de Microsoft para dispositivos táctiles.
42. MixedRealityOpenXRSvc - Servicio OpenXR para realidad mixta.
43. MapsBroker - Servicio de mapas para la aplicación Mapas.
44. lfsvc - Cliente de servicios de lista de frecuencia.
45. LanmanServer - Servicio de servidor de red para compartir recursos.
46. HvHost - Anfitrión de Hyper-V para virtualización.
47. Fax - Servicio de fax para enviar y recibir faxes.
48. DialogBlockingService - Servicio de bloqueo de diálogos para aplicaciones de Windows.
49. DiagTrack - Recopilación de datos de diagnóstico para mejorar Windows.
50. diagsvc - Servicio de diagnóstico de Windows.
51. DevQueryBroker - Proporciona información sobre dispositivos conectados.
52. CertPropSvc - Servicio de propiedades del almacén de certificados.
53. bthserv - Servicio de Bluetooth para dispositivos inalámbricos.
54. BDESVC - Servicio de cifrado de unidad BitLocker.
55. autotimesvc - Servicio de actualización automática de la hora.
56. AppVClient - Cliente de la plataforma de virtualización de aplicaciones (App-V).